Date,Description,Type,Money In, Money Out, Balance
2022-12-28,YAXLEY SC          TINGS,CREDIT,5.00,,597.57
2022-12-28,3 YEAR FIXED CARD 4552061702205226,BP/SO,,675.95,592.57
2022-12-28,JAN MONZO          WARDROBE DOORS,BP/SO,,200.00,1268.52
2022-12-28,AUTOAVE,PURCHASE,,202.00,1468.52
2022-12-28,BETTER FOOD,PURCHASE,,55.88,1670.52
2022-12-23,R Phillips         Merry Christmas  D,CREDIT,50.00,,1726.40


